training
Bpro-Space_invaders-Trial1	./learnerBpro -s 1 -c bpro.cfg -r ../roms/space_invaders.bin -n Bpro-Space_invaders-Trial1
Bpro-Space_invaders-Trial2	./learnerBpro -s 2 -c bpro.cfg -r ../roms/space_invaders.bin -n Bpro-Space_invaders-Trial2
Bpro-Space_invaders-Trial3	./learnerBpro -s 3 -c bpro.cfg -r ../roms/space_invaders.bin -n Bpro-Space_invaders-Trial3
Bpro-Space_invaders-Trial4	./learnerBpro -s 4 -c bpro.cfg -r ../roms/space_invaders.bin -n Bpro-Space_invaders-Trial4
Bpro-Space_invaders-Trial5	./learnerBpro -s 5 -c bpro.cfg -r ../roms/space_invaders.bin -n Bpro-Space_invaders-Trial5
Bpro-Space_invaders-Trial6	./learnerBpro -s 6 -c bpro.cfg -r ../roms/space_invaders.bin -n Bpro-Space_invaders-Trial6
Bpro-Space_invaders-Trial7	./learnerBpro -s 7 -c bpro.cfg -r ../roms/space_invaders.bin -n Bpro-Space_invaders-Trial7
Bpro-Space_invaders-Trial8	./learnerBpro -s 8 -c bpro.cfg -r ../roms/space_invaders.bin -n Bpro-Space_invaders-Trial8
Bpro-Space_invaders-Trial9	./learnerBpro -s 9 -c bpro.cfg -r ../roms/space_invaders.bin -n Bpro-Space_invaders-Trial9
Bpro-Space_invaders-Trial10	./learnerBpro -s 10 -c bpro.cfg -r ../roms/space_invaders.bin -n Bpro-Space_invaders-Trial10
Bpro-Space_invaders-Trial11	./learnerBpro -s 11 -c bpro.cfg -r ../roms/space_invaders.bin -n Bpro-Space_invaders-Trial11
Bpro-Space_invaders-Trial12	./learnerBpro -s 12 -c bpro.cfg -r ../roms/space_invaders.bin -n Bpro-Space_invaders-Trial12
Bpro-Space_invaders-Trial13	./learnerBpro -s 13 -c bpro.cfg -r ../roms/space_invaders.bin -n Bpro-Space_invaders-Trial13
Bpro-Space_invaders-Trial14	./learnerBpro -s 14 -c bpro.cfg -r ../roms/space_invaders.bin -n Bpro-Space_invaders-Trial14
Bpro-Space_invaders-Trial15	./learnerBpro -s 15 -c bpro.cfg -r ../roms/space_invaders.bin -n Bpro-Space_invaders-Trial15
Bpro-Space_invaders-Trial16	./learnerBpro -s 16 -c bpro.cfg -r ../roms/space_invaders.bin -n Bpro-Space_invaders-Trial16
Bpro-Space_invaders-Trial17	./learnerBpro -s 17 -c bpro.cfg -r ../roms/space_invaders.bin -n Bpro-Space_invaders-Trial17
Bpro-Space_invaders-Trial18	./learnerBpro -s 18 -c bpro.cfg -r ../roms/space_invaders.bin -n Bpro-Space_invaders-Trial18
Bpro-Space_invaders-Trial19	./learnerBpro -s 19 -c bpro.cfg -r ../roms/space_invaders.bin -n Bpro-Space_invaders-Trial19
Bpro-Space_invaders-Trial20	./learnerBpro -s 20 -c bpro.cfg -r ../roms/space_invaders.bin -n Bpro-Space_invaders-Trial20
Bpro-Space_invaders-Trial21	./learnerBpro -s 21 -c bpro.cfg -r ../roms/space_invaders.bin -n Bpro-Space_invaders-Trial21
Bpro-Space_invaders-Trial22	./learnerBpro -s 22 -c bpro.cfg -r ../roms/space_invaders.bin -n Bpro-Space_invaders-Trial22
Bpro-Space_invaders-Trial23	./learnerBpro -s 23 -c bpro.cfg -r ../roms/space_invaders.bin -n Bpro-Space_invaders-Trial23
Bpro-Space_invaders-Trial24	./learnerBpro -s 24 -c bpro.cfg -r ../roms/space_invaders.bin -n Bpro-Space_invaders-Trial24
Bpro-Space_invaders-Trial25	./learnerBpro -s 25 -c bpro.cfg -r ../roms/space_invaders.bin -n Bpro-Space_invaders-Trial25
Bpro-Space_invaders-Trial26	./learnerBpro -s 26 -c bpro.cfg -r ../roms/space_invaders.bin -n Bpro-Space_invaders-Trial26
Bpro-Space_invaders-Trial27	./learnerBpro -s 27 -c bpro.cfg -r ../roms/space_invaders.bin -n Bpro-Space_invaders-Trial27
Bpro-Space_invaders-Trial28	./learnerBpro -s 28 -c bpro.cfg -r ../roms/space_invaders.bin -n Bpro-Space_invaders-Trial28
Bpro-Space_invaders-Trial29	./learnerBpro -s 29 -c bpro.cfg -r ../roms/space_invaders.bin -n Bpro-Space_invaders-Trial29
Bpro-Space_invaders-Trial30	./learnerBpro -s 30 -c bpro.cfg -r ../roms/space_invaders.bin -n Bpro-Space_invaders-Trial30
Bpro-Asterix-Trial1	./learnerBpro -s 1 -c bpro.cfg -r ../roms/asterix.bin -n Bpro-Asterix-Trial1
Bpro-Asterix-Trial2	./learnerBpro -s 2 -c bpro.cfg -r ../roms/asterix.bin -n Bpro-Asterix-Trial2
Bpro-Asterix-Trial3	./learnerBpro -s 3 -c bpro.cfg -r ../roms/asterix.bin -n Bpro-Asterix-Trial3
Bpro-Asterix-Trial4	./learnerBpro -s 4 -c bpro.cfg -r ../roms/asterix.bin -n Bpro-Asterix-Trial4
Bpro-Asterix-Trial5	./learnerBpro -s 5 -c bpro.cfg -r ../roms/asterix.bin -n Bpro-Asterix-Trial5
Bpro-Asterix-Trial6	./learnerBpro -s 6 -c bpro.cfg -r ../roms/asterix.bin -n Bpro-Asterix-Trial6
Bpro-Asterix-Trial7	./learnerBpro -s 7 -c bpro.cfg -r ../roms/asterix.bin -n Bpro-Asterix-Trial7
Bpro-Asterix-Trial8	./learnerBpro -s 8 -c bpro.cfg -r ../roms/asterix.bin -n Bpro-Asterix-Trial8
Bpro-Asterix-Trial9	./learnerBpro -s 9 -c bpro.cfg -r ../roms/asterix.bin -n Bpro-Asterix-Trial9
Bpro-Asterix-Trial10	./learnerBpro -s 10 -c bpro.cfg -r ../roms/asterix.bin -n Bpro-Asterix-Trial10
Bpro-Asterix-Trial11	./learnerBpro -s 11 -c bpro.cfg -r ../roms/asterix.bin -n Bpro-Asterix-Trial11
Bpro-Asterix-Trial12	./learnerBpro -s 12 -c bpro.cfg -r ../roms/asterix.bin -n Bpro-Asterix-Trial12
Bpro-Asterix-Trial13	./learnerBpro -s 13 -c bpro.cfg -r ../roms/asterix.bin -n Bpro-Asterix-Trial13
Bpro-Asterix-Trial14	./learnerBpro -s 14 -c bpro.cfg -r ../roms/asterix.bin -n Bpro-Asterix-Trial14
Bpro-Asterix-Trial15	./learnerBpro -s 15 -c bpro.cfg -r ../roms/asterix.bin -n Bpro-Asterix-Trial15
Bpro-Asterix-Trial16	./learnerBpro -s 16 -c bpro.cfg -r ../roms/asterix.bin -n Bpro-Asterix-Trial16
Bpro-Asterix-Trial17	./learnerBpro -s 17 -c bpro.cfg -r ../roms/asterix.bin -n Bpro-Asterix-Trial17
Bpro-Asterix-Trial18	./learnerBpro -s 18 -c bpro.cfg -r ../roms/asterix.bin -n Bpro-Asterix-Trial18
Bpro-Asterix-Trial19	./learnerBpro -s 19 -c bpro.cfg -r ../roms/asterix.bin -n Bpro-Asterix-Trial19
Bpro-Asterix-Trial20	./learnerBpro -s 20 -c bpro.cfg -r ../roms/asterix.bin -n Bpro-Asterix-Trial20
Bpro-Asterix-Trial21	./learnerBpro -s 21 -c bpro.cfg -r ../roms/asterix.bin -n Bpro-Asterix-Trial21
Bpro-Asterix-Trial22	./learnerBpro -s 22 -c bpro.cfg -r ../roms/asterix.bin -n Bpro-Asterix-Trial22
Bpro-Asterix-Trial23	./learnerBpro -s 23 -c bpro.cfg -r ../roms/asterix.bin -n Bpro-Asterix-Trial23
Bpro-Asterix-Trial24	./learnerBpro -s 24 -c bpro.cfg -r ../roms/asterix.bin -n Bpro-Asterix-Trial24
Bpro-Asterix-Trial25	./learnerBpro -s 25 -c bpro.cfg -r ../roms/asterix.bin -n Bpro-Asterix-Trial25
Bpro-Asterix-Trial26	./learnerBpro -s 26 -c bpro.cfg -r ../roms/asterix.bin -n Bpro-Asterix-Trial26
Bpro-Asterix-Trial27	./learnerBpro -s 27 -c bpro.cfg -r ../roms/asterix.bin -n Bpro-Asterix-Trial27
Bpro-Asterix-Trial28	./learnerBpro -s 28 -c bpro.cfg -r ../roms/asterix.bin -n Bpro-Asterix-Trial28
Bpro-Asterix-Trial29	./learnerBpro -s 29 -c bpro.cfg -r ../roms/asterix.bin -n Bpro-Asterix-Trial29
Bpro-Asterix-Trial30	./learnerBpro -s 30 -c bpro.cfg -r ../roms/asterix.bin -n Bpro-Asterix-Trial30
Bpro-Beam_rider-Trial1	./learnerBpro -s 1 -c bpro.cfg -r ../roms/beam_rider.bin -n Bpro-Beam_rider-Trial1
Bpro-Beam_rider-Trial2	./learnerBpro -s 2 -c bpro.cfg -r ../roms/beam_rider.bin -n Bpro-Beam_rider-Trial2
Bpro-Beam_rider-Trial3	./learnerBpro -s 3 -c bpro.cfg -r ../roms/beam_rider.bin -n Bpro-Beam_rider-Trial3
Bpro-Beam_rider-Trial4	./learnerBpro -s 4 -c bpro.cfg -r ../roms/beam_rider.bin -n Bpro-Beam_rider-Trial4
Bpro-Beam_rider-Trial5	./learnerBpro -s 5 -c bpro.cfg -r ../roms/beam_rider.bin -n Bpro-Beam_rider-Trial5
Bpro-Beam_rider-Trial6	./learnerBpro -s 6 -c bpro.cfg -r ../roms/beam_rider.bin -n Bpro-Beam_rider-Trial6
Bpro-Beam_rider-Trial7	./learnerBpro -s 7 -c bpro.cfg -r ../roms/beam_rider.bin -n Bpro-Beam_rider-Trial7
Bpro-Beam_rider-Trial8	./learnerBpro -s 8 -c bpro.cfg -r ../roms/beam_rider.bin -n Bpro-Beam_rider-Trial8
Bpro-Beam_rider-Trial9	./learnerBpro -s 9 -c bpro.cfg -r ../roms/beam_rider.bin -n Bpro-Beam_rider-Trial9
Bpro-Beam_rider-Trial10	./learnerBpro -s 10 -c bpro.cfg -r ../roms/beam_rider.bin -n Bpro-Beam_rider-Trial10
Bpro-Beam_rider-Trial11	./learnerBpro -s 11 -c bpro.cfg -r ../roms/beam_rider.bin -n Bpro-Beam_rider-Trial11
Bpro-Beam_rider-Trial12	./learnerBpro -s 12 -c bpro.cfg -r ../roms/beam_rider.bin -n Bpro-Beam_rider-Trial12
Bpro-Beam_rider-Trial13	./learnerBpro -s 13 -c bpro.cfg -r ../roms/beam_rider.bin -n Bpro-Beam_rider-Trial13
Bpro-Beam_rider-Trial14	./learnerBpro -s 14 -c bpro.cfg -r ../roms/beam_rider.bin -n Bpro-Beam_rider-Trial14
Bpro-Beam_rider-Trial15	./learnerBpro -s 15 -c bpro.cfg -r ../roms/beam_rider.bin -n Bpro-Beam_rider-Trial15
Bpro-Beam_rider-Trial16	./learnerBpro -s 16 -c bpro.cfg -r ../roms/beam_rider.bin -n Bpro-Beam_rider-Trial16
Bpro-Beam_rider-Trial17	./learnerBpro -s 17 -c bpro.cfg -r ../roms/beam_rider.bin -n Bpro-Beam_rider-Trial17
Bpro-Beam_rider-Trial18	./learnerBpro -s 18 -c bpro.cfg -r ../roms/beam_rider.bin -n Bpro-Beam_rider-Trial18
Bpro-Beam_rider-Trial19	./learnerBpro -s 19 -c bpro.cfg -r ../roms/beam_rider.bin -n Bpro-Beam_rider-Trial19
Bpro-Beam_rider-Trial20	./learnerBpro -s 20 -c bpro.cfg -r ../roms/beam_rider.bin -n Bpro-Beam_rider-Trial20
Bpro-Beam_rider-Trial21	./learnerBpro -s 21 -c bpro.cfg -r ../roms/beam_rider.bin -n Bpro-Beam_rider-Trial21
Bpro-Beam_rider-Trial22	./learnerBpro -s 22 -c bpro.cfg -r ../roms/beam_rider.bin -n Bpro-Beam_rider-Trial22
Bpro-Beam_rider-Trial23	./learnerBpro -s 23 -c bpro.cfg -r ../roms/beam_rider.bin -n Bpro-Beam_rider-Trial23
Bpro-Beam_rider-Trial24	./learnerBpro -s 24 -c bpro.cfg -r ../roms/beam_rider.bin -n Bpro-Beam_rider-Trial24
Bpro-Beam_rider-Trial25	./learnerBpro -s 25 -c bpro.cfg -r ../roms/beam_rider.bin -n Bpro-Beam_rider-Trial25
Bpro-Beam_rider-Trial26	./learnerBpro -s 26 -c bpro.cfg -r ../roms/beam_rider.bin -n Bpro-Beam_rider-Trial26
Bpro-Beam_rider-Trial27	./learnerBpro -s 27 -c bpro.cfg -r ../roms/beam_rider.bin -n Bpro-Beam_rider-Trial27
Bpro-Beam_rider-Trial28	./learnerBpro -s 28 -c bpro.cfg -r ../roms/beam_rider.bin -n Bpro-Beam_rider-Trial28
Bpro-Beam_rider-Trial29	./learnerBpro -s 29 -c bpro.cfg -r ../roms/beam_rider.bin -n Bpro-Beam_rider-Trial29
Bpro-Beam_rider-Trial30	./learnerBpro -s 30 -c bpro.cfg -r ../roms/beam_rider.bin -n Bpro-Beam_rider-Trial30
Bpro-Freeway_rider-Trial1	./learnerBpro -s 1 -c bpro.cfg -r ../roms/freeway.bin -n Bpro-Freeway-Trial1
Bpro-Freeway_rider-Trial2	./learnerBpro -s 2 -c bpro.cfg -r ../roms/freeway.bin -n Bpro-Freeway-Trial2
Bpro-Freeway_rider-Trial3	./learnerBpro -s 3 -c bpro.cfg -r ../roms/freeway.bin -n Bpro-Freeway-Trial3
Bpro-Freeway_rider-Trial4	./learnerBpro -s 4 -c bpro.cfg -r ../roms/freeway.bin -n Bpro-Freeway-Trial4
Bpro-Freeway_rider-Trial5	./learnerBpro -s 5 -c bpro.cfg -r ../roms/freeway.bin -n Bpro-Freeway-Trial5
Bpro-Freeway_rider-Trial6	./learnerBpro -s 6 -c bpro.cfg -r ../roms/freeway.bin -n Bpro-Freeway-Trial6
Bpro-Freeway_rider-Trial7	./learnerBpro -s 7 -c bpro.cfg -r ../roms/freeway.bin -n Bpro-Freeway-Trial7
Bpro-Freeway_rider-Trial8	./learnerBpro -s 8 -c bpro.cfg -r ../roms/freeway.bin -n Bpro-Freeway-Trial8
Bpro-Freeway_rider-Trial9	./learnerBpro -s 9 -c bpro.cfg -r ../roms/freeway.bin -n Bpro-Freeway-Trial9
Bpro-Freeway_rider-Trial10	./learnerBpro -s 10 -c bpro.cfg -r ../roms/freeway.bin -n Bpro-Freeway-Trial10
Bpro-Freeway_rider-Trial11	./learnerBpro -s 11 -c bpro.cfg -r ../roms/freeway.bin -n Bpro-Freeway-Trial11
Bpro-Freeway_rider-Trial12	./learnerBpro -s 12 -c bpro.cfg -r ../roms/freeway.bin -n Bpro-Freeway-Trial12
Bpro-Freeway_rider-Trial13	./learnerBpro -s 13 -c bpro.cfg -r ../roms/freeway.bin -n Bpro-Freeway-Trial13
Bpro-Freeway_rider-Trial14	./learnerBpro -s 14 -c bpro.cfg -r ../roms/freeway.bin -n Bpro-Freeway-Trial14
Bpro-Freeway_rider-Trial15	./learnerBpro -s 15 -c bpro.cfg -r ../roms/freeway.bin -n Bpro-Freeway-Trial15
Bpro-Freeway_rider-Trial16	./learnerBpro -s 16 -c bpro.cfg -r ../roms/freeway.bin -n Bpro-Freeway-Trial16
Bpro-Freeway_rider-Trial17	./learnerBpro -s 17 -c bpro.cfg -r ../roms/freeway.bin -n Bpro-Freeway-Trial17
Bpro-Freeway_rider-Trial18	./learnerBpro -s 18 -c bpro.cfg -r ../roms/freeway.bin -n Bpro-Freeway-Trial18
Bpro-Freeway_rider-Trial19	./learnerBpro -s 19 -c bpro.cfg -r ../roms/freeway.bin -n Bpro-Freeway-Trial19
Bpro-Freeway_rider-Trial20	./learnerBpro -s 20 -c bpro.cfg -r ../roms/freeway.bin -n Bpro-Freeway-Trial20
Bpro-Freeway_rider-Trial21	./learnerBpro -s 21 -c bpro.cfg -r ../roms/freeway.bin -n Bpro-Freeway-Trial21
Bpro-Freeway_rider-Trial22	./learnerBpro -s 22 -c bpro.cfg -r ../roms/freeway.bin -n Bpro-Freeway-Trial22
Bpro-Freeway_rider-Trial23	./learnerBpro -s 23 -c bpro.cfg -r ../roms/freeway.bin -n Bpro-Freeway-Trial23
Bpro-Freeway_rider-Trial24	./learnerBpro -s 24 -c bpro.cfg -r ../roms/freeway.bin -n Bpro-Freeway-Trial24
Bpro-Freeway_rider-Trial25	./learnerBpro -s 25 -c bpro.cfg -r ../roms/freeway.bin -n Bpro-Freeway-Trial25
Bpro-Freeway_rider-Trial26	./learnerBpro -s 26 -c bpro.cfg -r ../roms/freeway.bin -n Bpro-Freeway-Trial26
Bpro-Freeway_rider-Trial27	./learnerBpro -s 27 -c bpro.cfg -r ../roms/freeway.bin -n Bpro-Freeway-Trial27
Bpro-Freeway_rider-Trial28	./learnerBpro -s 28 -c bpro.cfg -r ../roms/freeway.bin -n Bpro-Freeway-Trial28
Bpro-Freeway_rider-Trial29	./learnerBpro -s 29 -c bpro.cfg -r ../roms/freeway.bin -n Bpro-Freeway-Trial29
Bpro-Freeway_rider-Trial30	./learnerBpro -s 30 -c bpro.cfg -r ../roms/freeway.bin -n Bpro-Freeway-Trial30
Bpro-Seaquest-Trial1	./learnerBpro -s 1 -c bpro.cfg -r ../roms/seaquest.bin -n Bpro-Seaquest-Trial1
Bpro-Seaquest-Trial2	./learnerBpro -s 2 -c bpro.cfg -r ../roms/seaquest.bin -n Bpro-Seaquest-Trial2
Bpro-Seaquest-Trial3	./learnerBpro -s 3 -c bpro.cfg -r ../roms/seaquest.bin -n Bpro-Seaquest-Trial3
Bpro-Seaquest-Trial4	./learnerBpro -s 4 -c bpro.cfg -r ../roms/seaquest.bin -n Bpro-Seaquest-Trial4
Bpro-Seaquest-Trial5	./learnerBpro -s 5 -c bpro.cfg -r ../roms/seaquest.bin -n Bpro-Seaquest-Trial5
Bpro-Seaquest-Trial6	./learnerBpro -s 6 -c bpro.cfg -r ../roms/seaquest.bin -n Bpro-Seaquest-Trial6
Bpro-Seaquest-Trial7	./learnerBpro -s 7 -c bpro.cfg -r ../roms/seaquest.bin -n Bpro-Seaquest-Trial7
Bpro-Seaquest-Trial8	./learnerBpro -s 8 -c bpro.cfg -r ../roms/seaquest.bin -n Bpro-Seaquest-Trial8
Bpro-Seaquest-Trial9	./learnerBpro -s 9 -c bpro.cfg -r ../roms/seaquest.bin -n Bpro-Seaquest-Trial9
Bpro-Seaquest-Trial10	./learnerBpro -s 10 -c bpro.cfg -r ../roms/seaquest.bin -n Bpro-Seaquest-Trial10
Bpro-Seaquest-Trial11	./learnerBpro -s 11 -c bpro.cfg -r ../roms/seaquest.bin -n Bpro-Seaquest-Trial11
Bpro-Seaquest-Trial12	./learnerBpro -s 12 -c bpro.cfg -r ../roms/seaquest.bin -n Bpro-Seaquest-Trial12
Bpro-Seaquest-Trial13	./learnerBpro -s 13 -c bpro.cfg -r ../roms/seaquest.bin -n Bpro-Seaquest-Trial13
Bpro-Seaquest-Trial14	./learnerBpro -s 14 -c bpro.cfg -r ../roms/seaquest.bin -n Bpro-Seaquest-Trial14
Bpro-Seaquest-Trial15	./learnerBpro -s 15 -c bpro.cfg -r ../roms/seaquest.bin -n Bpro-Seaquest-Trial15
Bpro-Seaquest-Trial16	./learnerBpro -s 16 -c bpro.cfg -r ../roms/seaquest.bin -n Bpro-Seaquest-Trial16
Bpro-Seaquest-Trial17	./learnerBpro -s 17 -c bpro.cfg -r ../roms/seaquest.bin -n Bpro-Seaquest-Trial17
Bpro-Seaquest-Trial18	./learnerBpro -s 18 -c bpro.cfg -r ../roms/seaquest.bin -n Bpro-Seaquest-Trial18
Bpro-Seaquest-Trial19	./learnerBpro -s 19 -c bpro.cfg -r ../roms/seaquest.bin -n Bpro-Seaquest-Trial19
Bpro-Seaquest-Trial20	./learnerBpro -s 20 -c bpro.cfg -r ../roms/seaquest.bin -n Bpro-Seaquest-Trial20
Bpro-Seaquest-Trial21	./learnerBpro -s 21 -c bpro.cfg -r ../roms/seaquest.bin -n Bpro-Seaquest-Trial21
Bpro-Seaquest-Trial22	./learnerBpro -s 22 -c bpro.cfg -r ../roms/seaquest.bin -n Bpro-Seaquest-Trial22
Bpro-Seaquest-Trial23	./learnerBpro -s 23 -c bpro.cfg -r ../roms/seaquest.bin -n Bpro-Seaquest-Trial23
Bpro-Seaquest-Trial24	./learnerBpro -s 24 -c bpro.cfg -r ../roms/seaquest.bin -n Bpro-Seaquest-Trial24
Bpro-Seaquest-Trial25	./learnerBpro -s 25 -c bpro.cfg -r ../roms/seaquest.bin -n Bpro-Seaquest-Trial25
Bpro-Seaquest-Trial26	./learnerBpro -s 26 -c bpro.cfg -r ../roms/seaquest.bin -n Bpro-Seaquest-Trial26
Bpro-Seaquest-Trial27	./learnerBpro -s 27 -c bpro.cfg -r ../roms/seaquest.bin -n Bpro-Seaquest-Trial27
Bpro-Seaquest-Trial28	./learnerBpro -s 28 -c bpro.cfg -r ../roms/seaquest.bin -n Bpro-Seaquest-Trial28
Bpro-Seaquest-Trial29	./learnerBpro -s 29 -c bpro.cfg -r ../roms/seaquest.bin -n Bpro-Seaquest-Trial29
Bpro-Seaquest-Trial30	./learnerBpro -s 30 -c bpro.cfg -r ../roms/seaquest.bin -n Bpro-Seaquest-Trial30
Bpro-Pong-Trial1	./learnerBpro -s 1 -c bpro.cfg -r ../roms/pong.bin -n Bpro-Pong-Trial1
Bpro-Pong-Trial2	./learnerBpro -s 2 -c bpro.cfg -r ../roms/pong.bin -n Bpro-Pong-Trial2
Bpro-Pong-Trial3	./learnerBpro -s 3 -c bpro.cfg -r ../roms/pong.bin -n Bpro-Pong-Trial3
Bpro-Pong-Trial4	./learnerBpro -s 4 -c bpro.cfg -r ../roms/pong.bin -n Bpro-Pong-Trial4
Bpro-Pong-Trial5	./learnerBpro -s 5 -c bpro.cfg -r ../roms/pong.bin -n Bpro-Pong-Trial5
Bpro-Pong-Trial6	./learnerBpro -s 6 -c bpro.cfg -r ../roms/pong.bin -n Bpro-Pong-Trial6
Bpro-Pong-Trial7	./learnerBpro -s 7 -c bpro.cfg -r ../roms/pong.bin -n Bpro-Pong-Trial7
Bpro-Pong-Trial8	./learnerBpro -s 8 -c bpro.cfg -r ../roms/pong.bin -n Bpro-Pong-Trial8
Bpro-Pong-Trial9	./learnerBpro -s 9 -c bpro.cfg -r ../roms/pong.bin -n Bpro-Pong-Trial9
Bpro-Pong-Trial10	./learnerBpro -s 10 -c bpro.cfg -r ../roms/pong.bin -n Bpro-Pong-Trial10
Bpro-Pong-Trial11	./learnerBpro -s 11 -c bpro.cfg -r ../roms/pong.bin -n Bpro-Pong-Trial11
Bpro-Pong-Trial12	./learnerBpro -s 12 -c bpro.cfg -r ../roms/pong.bin -n Bpro-Pong-Trial12
Bpro-Pong-Trial13	./learnerBpro -s 13 -c bpro.cfg -r ../roms/pong.bin -n Bpro-Pong-Trial13
Bpro-Pong-Trial14	./learnerBpro -s 14 -c bpro.cfg -r ../roms/pong.bin -n Bpro-Pong-Trial14
Bpro-Pong-Trial15	./learnerBpro -s 15 -c bpro.cfg -r ../roms/pong.bin -n Bpro-Pong-Trial15
Bpro-Pong-Trial16	./learnerBpro -s 16 -c bpro.cfg -r ../roms/pong.bin -n Bpro-Pong-Trial16
Bpro-Pong-Trial17	./learnerBpro -s 17 -c bpro.cfg -r ../roms/pong.bin -n Bpro-Pong-Trial17
Bpro-Pong-Trial18	./learnerBpro -s 18 -c bpro.cfg -r ../roms/pong.bin -n Bpro-Pong-Trial18
Bpro-Pong-Trial19	./learnerBpro -s 19 -c bpro.cfg -r ../roms/pong.bin -n Bpro-Pong-Trial19
Bpro-Pong-Trial20	./learnerBpro -s 20 -c bpro.cfg -r ../roms/pong.bin -n Bpro-Pong-Trial20
Bpro-Pong-Trial21	./learnerBpro -s 21 -c bpro.cfg -r ../roms/pong.bin -n Bpro-Pong-Trial21
Bpro-Pong-Trial22	./learnerBpro -s 22 -c bpro.cfg -r ../roms/pong.bin -n Bpro-Pong-Trial22
Bpro-Pong-Trial23	./learnerBpro -s 23 -c bpro.cfg -r ../roms/pong.bin -n Bpro-Pong-Trial23
Bpro-Pong-Trial24	./learnerBpro -s 24 -c bpro.cfg -r ../roms/pong.bin -n Bpro-Pong-Trial24
Bpro-Pong-Trial25	./learnerBpro -s 25 -c bpro.cfg -r ../roms/pong.bin -n Bpro-Pong-Trial25
Bpro-Pong-Trial26	./learnerBpro -s 26 -c bpro.cfg -r ../roms/pong.bin -n Bpro-Pong-Trial26
Bpro-Pong-Trial27	./learnerBpro -s 27 -c bpro.cfg -r ../roms/pong.bin -n Bpro-Pong-Trial27
Bpro-Pong-Trial28	./learnerBpro -s 28 -c bpro.cfg -r ../roms/pong.bin -n Bpro-Pong-Trial28
Bpro-Pong-Trial29	./learnerBpro -s 29 -c bpro.cfg -r ../roms/pong.bin -n Bpro-Pong-Trial29
Bpro-Pong-Trial30	./learnerBpro -s 30 -c bpro.cfg -r ../roms/pong.bin -n Bpro-Pong-Trial30
